92
33
27 27 27 27 27 27 27 27 27 27 27 27 27 27 27 27 27 27 27 27 27 27 27 27 27 27 27 27 27 27 27 27 27 27 27 27 27 27 27 27 27 27 27 27 27 27 27 27 27 27 27 27 27 27 27 27 27 27 27 27 27 27 27 27 27 27 27 27 27 27 27 27 27 27 27 27 27 27 27 27 27 27 27 27 27 27 27 27 28 28 28 28 
28 0 0 0 0 0 0 0 0 0 0 0 0 0 0 0 0 0 0 0 0 0 0 0 0 0 0 0 0 0 0 0 0 0 0 0 0 0 0 0 0 0 0 0 0 0 0 0 0 0 0 0 0 0 0 0 0 0 0 0 0 0 0 0 0 0 0 0 0 0 0 0 0 0 0 0 0 0 0 0 0 0 0 0 0 0 0 28 0 0 0 28 
28 12 13 0 0 0 0 0 0 0 0 0 0 0 0 0 0 0 0 0 0 0 0 0 0 0 0 0 0 0 0 0 0 0 0 0 0 0 0 0 0 0 0 0 0 0 0 0 0 0 0 0 0 0 0 0 0 0 0 0 0 0 0 0 0 0 0 0 0 0 0 0 0 0 0 0 0 0 0 0 0 0 0 0 0 0 0 28 0 0 0 28 
28 14 15 0 0 0 0 20 21 0 0 0 0 0 20 21 0 0 0 0 0 0 0 0 0 0 0 0 0 0 0 0 0 0 0 0 0 0 0 0 0 0 0 0 0 0 0 0 0 0 0 0 0 0 0 0 0 0 0 0 0 0 0 0 0 0 0 0 0 0 0 0 0 0 0 0 0 0 0 0 0 0 0 0 0 0 0 28 0 28 28 28 
28 27 27 27 27 27 27 27 27 27 0 0 0 0 28 28 0 0 0 0 0 0 0 0 0 0 0 0 0 0 0 0 0 0 0 0 0 0 0 0 0 0 0 0 0 0 0 0 0 0 0 0 0 0 0 0 0 0 0 0 0 0 0 0 0 0 0 0 0 0 0 0 0 0 0 0 0 0 0 0 0 0 0 0 0 28 28 28 0 0 0 28 
28 0 0 0 0 0 0 0 0 0 0 0 0 0 28 28 0 0 0 0 0 0 0 0 0 0 0 0 0 0 0 0 0 0 0 0 0 0 0 0 0 0 0 0 0 0 0 0 0 0 0 0 0 0 0 0 0 0 0 0 0 0 0 0 0 0 0 0 0 0 0 0 0 0 0 0 0 0 0 0 0 0 0 0 28 0 0 28 28 0 0 28 
28 0 0 0 0 0 0 0 0 0 0 0 0 0 28 28 0 0 0 0 0 0 0 0 0 0 0 0 35 0 0 0 0 0 0 0 0 0 0 0 0 0 0 0 0 0 0 0 0 0 0 0 0 0 0 0 0 0 0 0 0 0 0 0 0 0 0 0 0 0 0 0 0 0 0 0 28 0 0 0 0 28 0 0 0 0 0 28 28 28 28 28 
28 0 0 0 0 0 0 0 0 0 0 0 0 0 28 28 0 0 0 0 0 0 0 0 0 35 0 0 0 0 0 26 25 0 0 0 26 25 0 0 0 35 0 0 0 0 0 0 0 0 0 0 0 0 0 0 0 0 0 0 0 0 0 0 0 0 0 0 0 0 0 28 28 28 0 0 28 28 28 28 28 28 0 0 0 0 0 28 28 28 28 28 
28 0 0 0 0 0 0 0 0 0 0 0 0 0 28 28 0 0 0 0 0 0 0 0 0 0 0 0 0 0 0 0 0 0 0 0 0 0 0 0 0 0 0 0 0 0 0 0 0 0 0 0 0 0 0 0 0 0 0 0 0 0 0 0 0 0 0 0 0 0 28 28 27 28 0 0 28 27 27 27 27 28 0 0 0 0 0 28 28 28 28 28 
28 0 0 0 0 0 0 0 0 0 0 0 0 0 28 28 0 0 0 0 0 0 0 35 0 0 0 0 0 0 0 0 0 0 0 0 0 0 0 0 0 0 0 0 0 0 0 0 0 0 0 0 0 0 0 0 0 0 0 0 0 0 0 0 0 0 0 0 0 28 28 27 27 28 0 0 28 27 27 27 27 28 0 0 0 0 0 28 28 28 28 28 
28 0 0 0 0 0 0 0 0 0 0 0 0 0 28 28 0 0 0 0 0 0 0 0 35 0 0 35 0 0 0 0 0 0 0 0 0 0 0 0 0 0 0 0 0 0 0 0 0 0 0 0 0 0 0 0 0 0 0 0 0 0 0 0 0 0 0 0 28 27 27 27 27 28 0 0 28 27 27 27 27 28 0 0 0 0 0 28 28 28 28 28 
28 0 0 0 0 0 0 0 0 28 0 0 0 0 28 28 0 0 0 0 0 0 0 0 0 0 0 0 35 0 0 0 0 0 0 0 0 0 22 0 0 0 0 0 0 0 28 0 0 0 0 0 0 0 0 0 0 0 0 0 0 0 0 0 0 0 0 28 28 27 27 27 27 28 0 0 28 27 27 27 27 28 0 0 0 0 0 28 28 28 28 28 
28 0 0 0 0 0 0 0 0 28 28 28 28 28 28 28 0 0 0 0 0 0 0 0 0 0 0 0 0 0 26 25 0 0 0 0 0 0 28 0 0 0 0 0 0 28 28 0 0 0 0 0 0 0 0 0 0 0 0 0 0 0 0 0 0 0 28 28 27 27 27 27 27 28 0 0 28 27 27 27 27 28 0 0 0 0 0 28 28 28 28 28 
28 0 0 0 0 0 0 0 0 0 0 0 0 0 0 0 0 0 0 0 0 0 0 0 0 0 0 0 0 0 0 0 0 0 28 0 0 0 28 0 0 0 1 0 28 28 28 0 0 0 0 0 0 0 0 0 0 0 0 0 0 0 0 0 0 28 27 27 27 27 27 27 27 28 0 0 28 27 27 27 27 28 0 0 0 0 0 28 28 28 28 28 
28 0 0 0 0 28 28 0 0 0 0 0 0 0 0 0 0 0 0 0 0 0 0 0 0 0 0 0 0 0 0 0 35 0 28 28 28 28 28 28 28 28 28 28 28 28 28 28 28 28 28 28 0 0 0 35 0 0 28 0 0 0 0 0 0 28 27 27 27 27 27 27 27 28 0 0 28 27 27 27 27 28 0 0 0 0 0 28 28 28 28 28 
28 0 0 0 0 0 0 0 0 0 0 0 0 0 0 0 0 0 0 0 0 0 0 0 0 0 0 0 0 0 0 35 0 0 0 0 0 0 0 0 28 27 27 27 27 27 27 27 27 27 27 28 35 0 0 0 0 0 28 0 0 0 0 35 0 28 27 27 27 27 27 27 27 28 0 0 28 27 27 27 27 28 0 0 0 0 0 28 28 28 28 28 
28 0 28 0 0 0 0 0 0 0 0 0 0 0 0 0 0 0 0 0 0 0 0 0 0 0 0 0 0 0 35 0 0 0 0 0 0 0 0 0 28 27 27 27 27 27 27 27 27 27 27 28 0 0 35 0 0 0 28 0 35 0 0 0 0 28 27 27 27 27 27 27 27 28 0 0 28 27 27 27 27 28 0 0 0 0 0 28 28 28 28 28 
28 0 0 0 0 0 0 0 0 0 0 0 0 0 0 0 0 0 0 0 0 0 0 0 0 0 0 0 0 35 0 0 0 0 0 0 0 0 0 0 28 27 27 27 27 27 27 27 27 27 27 28 0 0 0 0 25 0 28 0 0 0 0 0 0 28 27 27 27 27 27 27 27 28 0 0 28 27 27 27 27 28 0 0 0 0 0 28 28 28 28 28 
28 0 0 0 28 0 0 0 0 0 0 0 0 0 0 0 0 0 0 0 0 0 0 0 0 0 0 0 35 0 0 0 0 0 0 0 0 0 0 0 28 27 27 27 27 27 27 27 27 27 27 28 0 0 0 24 0 0 28 0 0 0 0 0 0 28 27 27 27 27 27 27 27 28 0 0 28 27 27 27 27 28 0 0 0 0 0 28 28 28 28 28 
28 0 0 0 0 0 0 0 0 0 28 0 0 28 0 0 0 0 0 0 0 0 0 0 0 0 0 0 0 0 0 0 0 0 0 0 0 0 0 0 28 27 27 27 27 27 27 27 27 27 27 28 0 0 26 0 0 0 28 0 0 0 0 0 0 28 27 27 27 27 27 27 27 28 0 0 28 27 27 27 27 28 0 0 0 0 0 28 28 28 28 28 
28 0 0 0 28 0 0 28 0 0 28 28 28 28 26 0 0 0 0 0 25 28 28 0 0 28 28 0 0 0 0 0 0 0 0 28 28 0 0 0 28 27 27 27 27 27 27 27 27 27 27 28 26 0 0 0 0 0 28 0 0 0 0 0 0 28 27 27 27 27 27 27 27 28 0 0 28 27 27 27 27 28 0 0 0 0 0 28 28 28 28 28 
28 0 0 0 0 0 0 28 0 0 28 28 28 28 0 26 0 0 0 25 0 28 28 0 0 28 28 26 0 0 0 0 0 0 25 28 28 0 0 0 28 27 27 27 27 27 27 27 27 27 27 28 0 26 0 0 0 0 28 0 0 0 0 0 0 28 28 28 28 28 28 28 28 28 0 0 28 28 28 28 27 28 0 0 0 0 0 28 28 28 28 28 
28 0 0 0 0 28 0 28 0 0 28 28 28 28 0 0 0 0 0 0 0 28 28 0 0 28 28 0 26 0 0 0 0 25 0 28 28 0 0 0 28 27 27 27 27 27 27 27 27 27 27 28 0 0 26 0 0 0 0 0 0 0 0 0 0 0 0 0 16 17 0 0 0 0 0 0 0 16 17 28 27 28 0 0 0 0 0 28 28 28 28 28 
28 0 0 28 0 0 0 28 0 0 28 28 28 28 0 0 0 0 0 0 0 28 28 0 0 28 28 0 0 26 0 0 25 0 0 28 28 0 0 0 28 27 27 27 27 27 27 27 27 27 27 28 0 0 0 26 0 0 0 0 0 0 0 0 0 0 0 0 18 19 0 0 0 0 0 0 0 18 19 28 27 28 0 0 0 0 0 28 28 28 28 28 
28 0 28 28 0 0 0 28 0 0 28 28 28 28 0 0 0 0 0 0 0 28 28 0 0 28 28 0 0 0 0 0 0 0 0 28 28 0 0 0 28 28 28 28 28 28 28 28 28 28 28 28 0 0 0 0 0 0 0 0 0 0 0 0 0 0 0 0 0 0 0 0 0 0 0 0 0 0 0 28 27 28 0 0 0 0 0 28 28 28 28 28 
28 0 0 0 0 0 0 28 0 0 28 28 28 28 0 0 0 0 0 0 0 28 28 0 0 28 28 0 0 0 0 0 0 0 0 28 28 0 0 0 0 0 28 0 0 0 0 0 28 0 0 0 0 0 0 0 28 28 0 0 0 0 0 0 28 0 0 0 0 0 28 0 0 0 0 0 0 0 0 28 28 28 0 0 0 0 0 28 28 28 28 28 
28 28 0 0 0 0 0 28 0 0 28 28 28 28 0 0 0 0 0 0 0 28 28 0 0 28 28 0 0 0 0 0 0 0 0 28 28 0 0 0 0 0 0 0 0 0 0 0 0 0 0 0 0 0 0 28 28 28 0 0 28 0 0 0 28 28 28 28 28 28 28 0 0 28 0 0 0 0 0 0 0 0 0 0 0 0 0 28 28 28 28 28 
28 0 0 0 0 0 0 28 0 0 28 28 28 28 0 0 0 0 0 0 0 28 28 0 0 28 28 0 0 0 0 0 0 0 0 28 28 0 0 0 0 0 0 0 0 28 0 0 0 0 0 28 0 0 0 28 27 28 0 0 28 0 0 0 28 27 27 27 27 27 28 28 28 28 0 0 28 28 0 0 0 0 0 0 0 0 0 28 28 28 28 28 
28 0 0 28 0 0 0 28 0 0 28 28 28 28 0 0 0 0 0 0 0 28 28 0 0 28 28 0 0 0 0 0 0 0 0 26 24 23 23 23 23 24 23 24 25 28 26 24 24 24 25 28 26 25 28 28 4 28 0 0 28 0 0 0 28 4 27 27 27 4 4 4 4 28 0 0 28 28 28 28 28 28 28 28 28 28 28 28 28 28 28 28 
28 0 0 0 0 0 0 28 0 0 28 28 28 28 0 0 0 0 0 0 0 28 28 0 0 28 28 0 0 0 0 0 0 0 0 0 0 0 0 0 0 0 0 0 0 28 0 0 0 0 0 28 0 0 28 4 4 28 0 0 28 0 0 0 28 4 4 4 4 4 4 4 4 28 0 0 28 4 4 4 4 4 4 4 4 4 4 28 28 28 28 28 
28 0 0 0 0 0 0 28 0 0 28 28 28 28 0 0 0 0 0 0 0 28 28 0 0 28 28 0 0 0 0 0 0 0 0 0 0 0 0 0 0 0 0 0 0 28 0 0 0 0 0 28 0 0 28 4 4 28 0 0 28 0 0 0 28 4 4 4 4 4 4 4 4 28 0 0 28 4 4 4 4 4 4 4 4 4 4 28 28 28 28 28 
28 0 0 0 0 0 0 28 0 0 28 28 28 28 0 0 0 0 0 0 0 28 28 0 0 28 28 0 0 0 0 0 0 0 0 0 0 0 0 0 0 0 0 0 0 28 0 0 0 0 0 28 0 0 28 4 4 28 0 0 28 0 0 0 28 4 4 4 4 4 4 4 4 28 0 0 28 4 4 4 4 4 4 4 4 4 4 28 28 28 28 28 
28 0 0 0 0 0 0 28 0 0 28 28 28 28 0 0 0 0 0 0 0 28 28 0 0 28 28 0 0 0 0 0 0 0 0 0 0 0 0 0 0 0 0 0 0 28 0 0 0 0 0 28 0 0 28 4 4 28 0 0 28 0 0 0 28 4 4 4 4 4 4 4 4 28 0 0 28 4 4 4 4 4 4 4 4 4 4 28 28 28 28 28 
