86
31
28 28 28 28 28 28 28 28 28 28 28 28 28 28 28 28 28 28 28 28 28 28 28 28 28 28 28 28 28 28 28 28 28 28 28 28 28 28 28 28 28 28 28 28 28 28 28 28 28 28 28 28 28 28 28 28 28 28 28 28 28 28 28 28 28 28 28 28 28 28 28 28 28 28 28 28 28 28 28 28 28 28 28 28 28 28 
28 0 0 0 0 0 0 0 0 0 0 0 0 0 0 0 0 0 0 0 0 0 0 0 0 0 0 0 0 0 0 0 0 0 0 11 11 11 0 0 0 0 0 11 11 11 0 0 0 0 0 0 0 0 0 0 0 0 0 0 0 0 0 0 0 0 0 0 0 0 0 0 0 0 0 0 0 0 0 0 0 0 0 0 0 27 
28 12 13 0 0 0 0 0 0 0 0 0 0 0 0 0 0 0 0 0 0 0 0 0 0 0 0 0 0 0 0 0 0 0 0 11 11 11 0 0 0 0 0 11 11 11 0 0 0 0 0 0 0 0 0 0 0 0 0 0 0 0 0 0 0 0 0 0 0 0 0 0 0 0 0 0 0 0 0 0 0 0 0 0 0 27 
28 14 15 0 0 0 0 20 21 0 0 0 0 0 0 0 0 0 0 0 0 0 0 0 0 0 0 0 0 0 0 0 0 0 0 11 11 11 0 0 0 0 0 11 11 11 0 0 0 0 0 0 0 0 0 0 0 0 0 0 0 0 0 0 0 0 0 0 0 0 0 0 0 0 0 0 0 0 0 0 0 0 0 0 0 27 
28 27 27 27 27 27 27 27 27 27 27 27 0 0 0 0 0 0 0 27 0 0 0 35 35 35 0 0 0 35 35 0 0 27 0 11 11 11 0 0 0 0 27 11 11 11 0 0 0 0 27 27 27 27 0 0 0 0 27 0 0 0 0 0 0 0 0 0 0 0 0 0 0 0 0 0 0 0 0 0 0 0 0 0 0 27 
28 0 0 11 11 11 11 0 0 0 0 0 0 0 0 0 0 0 24 27 0 0 0 0 0 0 0 0 0 0 0 0 0 27 0 11 11 11 0 0 0 0 27 11 11 11 0 0 0 0 27 0 0 0 0 0 0 0 27 0 0 0 0 0 0 0 0 0 0 0 25 0 0 0 26 0 0 0 0 0 0 0 0 0 0 27 
27 0 0 11 11 11 11 0 0 0 0 0 0 0 0 35 0 0 0 27 27 0 0 0 0 0 0 0 0 0 0 0 0 27 0 11 11 11 0 0 0 27 27 11 11 11 0 0 0 27 27 0 0 26 25 0 0 0 27 0 0 0 0 0 0 0 0 0 0 25 0 0 0 0 0 26 0 0 0 0 0 0 0 0 0 27 
27 0 0 11 11 11 11 0 0 0 0 0 0 0 0 0 0 0 0 27 27 27 0 0 0 0 0 0 0 0 0 0 0 27 0 11 11 11 0 0 27 27 27 11 11 11 0 0 27 27 27 0 0 0 0 0 35 0 27 0 0 0 0 0 0 0 0 0 25 0 0 0 0 0 0 0 26 0 0 0 0 0 0 0 0 27 
27 0 0 11 11 11 11 0 0 0 0 0 0 35 0 0 0 0 0 27 0 0 0 1 0 0 0 0 27 0 0 0 0 27 0 11 11 11 0 0 0 0 27 11 11 11 0 0 0 0 27 0 0 0 0 0 0 0 27 0 0 0 0 0 0 0 0 25 0 0 0 0 0 0 0 0 0 26 0 0 0 0 0 0 0 27 
27 0 0 11 11 11 11 0 0 0 0 0 0 0 0 0 0 24 0 27 27 27 27 27 27 27 27 27 27 27 27 0 0 27 27 27 27 27 27 27 27 27 27 27 27 27 27 27 27 27 27 0 0 0 35 0 0 0 27 0 0 0 0 0 0 0 25 0 0 0 0 0 0 1 0 0 0 0 26 35 35 35 35 0 0 27 
27 0 0 11 11 11 11 0 0 0 0 0 0 0 0 0 0 0 0 27 0 0 0 0 0 0 0 0 0 0 0 0 0 27 0 11 11 11 0 0 0 0 0 11 11 11 0 0 0 0 0 0 0 0 0 0 35 0 27 27 27 0 0 0 0 35 35 35 35 35 35 35 35 35 0 0 0 0 0 0 0 0 0 0 0 27 
27 0 0 11 11 11 11 0 0 0 0 0 35 0 0 0 0 0 0 0 0 0 0 0 0 0 0 0 0 0 0 0 35 0 0 11 11 11 0 0 0 0 0 11 11 11 0 0 0 0 0 0 0 0 0 0 0 0 0 0 0 0 0 0 0 0 0 0 0 0 0 0 0 0 0 0 0 0 0 0 0 0 0 0 0 27 
27 0 0 11 11 11 11 0 0 27 0 0 0 0 0 0 0 0 0 0 0 0 0 0 0 0 0 0 0 0 0 0 0 0 0 11 11 11 0 0 0 0 0 11 11 11 0 0 0 0 0 0 0 0 35 0 0 0 0 0 0 0 0 0 0 0 0 0 0 0 0 0 0 0 0 0 0 0 0 0 0 0 0 0 35 27 
27 27 27 27 27 27 27 27 27 27 0 0 0 0 0 0 0 0 0 0 0 0 0 0 0 0 0 0 0 0 35 0 0 0 0 11 11 11 0 0 0 0 0 11 11 11 0 0 0 0 0 0 0 0 0 0 0 0 0 0 0 0 0 0 0 0 0 0 0 0 0 0 0 0 0 0 0 0 0 0 0 0 0 0 0 27 
27 0 0 11 11 11 11 0 0 0 0 0 0 0 0 0 0 0 0 0 0 0 0 0 0 0 0 0 0 0 0 0 0 0 0 11 11 11 0 0 0 0 0 11 11 11 0 0 0 0 0 0 35 0 0 0 0 0 0 0 0 0 0 0 0 0 0 0 0 0 0 0 0 27 0 0 0 0 0 0 0 35 0 0 0 27 
27 0 0 11 11 11 11 0 0 0 0 0 0 0 0 0 0 0 0 0 0 0 0 0 0 0 35 0 0 0 0 0 26 25 0 11 11 11 0 0 0 0 0 11 11 11 0 0 0 0 0 0 0 0 0 0 0 0 0 0 0 0 0 0 0 0 0 0 0 0 0 0 0 27 0 0 0 0 0 0 0 0 0 0 0 27 
27 0 0 11 11 11 11 0 0 0 0 0 0 0 0 0 0 0 0 0 0 0 35 0 0 0 0 0 0 0 0 0 0 0 0 11 11 11 0 0 0 0 0 11 11 11 0 0 0 0 27 0 0 0 0 0 0 27 0 0 0 0 0 0 0 0 0 0 0 0 0 0 0 27 0 0 0 0 0 0 0 0 0 0 0 27 
27 0 0 11 11 11 11 0 0 0 0 27 0 0 0 27 0 0 0 27 0 0 0 0 0 0 0 0 0 0 0 35 35 0 0 11 11 11 0 0 0 0 0 11 11 11 0 0 0 0 27 0 0 0 0 0 0 27 0 0 0 0 0 0 0 0 0 0 0 0 0 0 0 27 0 0 0 0 0 0 0 0 0 0 35 27 
27 0 0 11 11 11 11 0 0 0 0 27 27 27 27 27 27 27 27 27 0 0 0 0 0 0 0 0 0 27 0 0 0 0 0 11 11 11 0 0 0 0 0 11 11 11 0 0 0 0 27 27 27 27 27 27 27 27 0 0 0 0 0 0 0 0 0 0 0 0 0 0 0 27 0 0 0 0 0 35 0 0 0 0 0 27 
27 0 0 11 11 11 11 0 0 0 0 27 0 16 17 11 11 16 17 0 0 0 0 0 0 0 0 0 27 27 0 0 0 0 0 11 11 11 0 0 0 0 0 11 11 11 0 0 0 0 27 27 6 6 6 6 27 27 0 0 0 0 0 0 0 0 0 0 0 0 0 0 0 27 0 0 0 0 0 0 0 0 0 0 0 27 
27 0 0 11 11 11 11 0 0 0 0 27 0 18 19 11 11 18 19 0 0 0 0 0 0 0 35 0 27 0 0 0 0 0 0 11 11 11 0 0 0 0 0 11 11 11 0 0 0 0 27 27 6 6 6 6 27 27 0 0 0 0 0 0 0 0 0 0 0 0 0 0 0 27 0 0 0 0 0 0 0 0 35 0 0 27 
27 0 0 11 11 11 11 0 0 0 0 27 0 0 0 11 11 0 0 0 0 0 0 0 0 0 0 0 27 0 0 0 0 0 0 11 11 11 0 0 0 0 0 11 11 11 0 0 0 0 27 27 27 27 27 27 27 27 0 0 0 0 0 0 0 0 0 0 0 0 0 0 0 27 0 0 0 0 0 0 0 0 0 0 0 27 
27 0 0 11 11 11 11 0 0 0 0 27 0 0 0 11 11 0 0 0 0 0 0 0 35 0 0 0 27 0 0 0 0 0 0 11 11 11 0 0 27 0 0 11 11 11 0 0 0 0 27 0 0 0 0 0 0 27 0 0 0 0 0 0 0 0 0 0 0 0 0 0 0 27 0 0 0 0 0 0 0 0 0 0 0 27 
27 0 0 11 11 11 27 0 0 0 0 27 0 0 0 11 11 0 0 0 0 0 0 0 0 0 0 35 27 0 0 0 0 35 0 11 27 27 27 27 27 0 0 11 11 11 0 0 0 0 27 0 0 0 0 0 0 27 0 0 0 0 0 0 0 0 0 0 0 0 0 0 0 27 0 0 0 0 0 0 0 0 0 0 35 27 
27 0 0 11 11 11 27 27 27 27 27 27 0 0 0 11 11 0 0 0 0 0 0 0 0 0 0 0 27 0 35 0 0 0 0 11 11 16 17 0 27 0 0 11 11 11 0 0 0 0 27 0 0 0 0 0 0 27 0 0 0 0 0 0 0 0 0 0 0 0 0 0 0 27 0 0 0 0 0 0 0 0 0 0 0 27 
27 0 0 11 11 11 27 0 0 0 0 27 0 0 0 11 11 0 0 0 0 0 0 0 0 35 0 0 27 0 0 0 0 0 0 11 11 18 19 0 27 0 0 11 11 11 0 0 0 0 27 0 0 0 0 0 0 27 0 0 0 0 0 0 0 0 0 0 0 0 0 0 0 27 0 0 0 0 0 0 35 0 0 0 0 27 
27 0 0 11 11 11 27 0 0 0 0 27 0 0 0 11 11 0 0 0 0 0 35 0 0 0 0 0 27 0 0 0 35 0 0 11 11 11 0 0 27 0 0 11 11 11 0 0 0 0 27 0 0 0 0 0 0 27 0 0 0 0 0 0 0 0 0 0 0 0 0 0 0 27 0 0 0 0 0 0 0 0 0 0 0 27 
27 0 0 11 11 11 27 0 0 0 0 27 0 0 0 11 11 0 0 0 0 0 0 0 0 0 0 0 27 0 0 0 0 0 0 11 11 11 0 0 27 0 0 11 11 11 0 0 0 0 27 0 0 0 0 0 0 27 0 0 0 0 0 0 0 0 0 0 0 0 0 0 0 27 0 0 0 0 0 0 0 0 0 0 0 27 
27 0 0 11 11 11 11 0 0 0 0 0 0 0 0 11 11 0 0 0 0 0 0 0 35 0 0 0 27 35 0 0 0 0 0 11 11 11 0 0 27 0 0 11 11 11 0 0 0 0 27 0 0 0 0 0 0 27 0 0 0 0 0 0 0 0 0 0 0 0 0 0 0 27 0 0 0 0 0 0 0 0 0 0 0 27 
27 0 0 11 11 11 11 0 0 0 0 0 0 0 0 11 11 0 0 0 0 0 35 0 0 0 0 0 27 0 0 0 0 0 0 11 11 11 0 0 27 0 0 11 11 11 0 0 0 0 27 0 0 0 0 0 0 27 0 0 0 0 0 0 0 0 0 0 0 0 0 0 0 27 0 0 0 0 0 2 0 0 0 0 0 27 
27 27 27 27 27 27 27 27 27 27 27 27 27 27 27 27 27 27 27 27 27 27 27 27 27 27 27 27 27 27 27 27 27 27 27 27 27 27 27 27 27 0 0 11 11 11 0 0 0 0 27 0 0 0 0 0 0 27 0 0 0 0 0 0 0 0 0 0 0 0 0 0 0 27 27 27 27 27 27 27 27 27 27 27 27 27 
