108
19
29 29 29 29 29 29 29 29 29 29 29 29 29 29 29 29 29 29 29 29 29 29 29 29 29 29 29 29 29 29 29 29 29 29 29 29 29 29 29 29 29 29 29 29 29 29 29 29 29 29 29 29 29 29 29 29 29 29 29 29 29 29 29 29 29 29 29 29 29 29 29 29 29 29 29 29 29 29 29 29 29 29 29 29 29 29 29 29 29 29 29 29 29 29 0 0 0 0 0 0 0 0 0 0 0 0 0 0 
29 29 29 29 29 29 29 29 29 29 29 29 29 29 29 29 29 29 29 29 29 29 29 29 29 29 29 29 29 29 29 29 29 29 29 29 29 29 29 29 29 29 29 29 29 29 29 29 29 29 29 29 29 29 29 29 29 29 29 29 29 29 29 29 29 29 29 29 29 29 29 29 29 29 29 29 29 29 29 29 29 29 29 29 29 29 29 29 29 29 29 29 29 29 0 0 0 0 0 0 0 0 0 0 0 0 0 0 
29 29 29 29 29 29 29 29 29 29 29 29 29 29 29 29 29 29 29 29 29 29 29 29 29 29 29 29 29 29 29 29 29 29 29 29 29 29 29 29 29 29 29 29 29 29 29 29 29 29 29 29 29 29 29 29 29 29 29 29 29 29 29 29 29 29 29 29 29 29 29 29 29 29 29 29 29 29 29 29 29 29 29 29 29 29 29 29 29 29 29 29 29 29 0 0 0 0 0 0 0 0 0 0 0 0 0 0 
29 29 29 29 29 29 29 29 29 29 29 29 29 29 29 29 29 29 29 29 29 29 29 29 29 29 29 29 29 29 29 29 29 29 29 29 29 29 29 29 29 29 29 29 29 29 29 29 29 29 29 29 29 29 29 29 29 29 29 29 29 29 29 29 29 29 29 29 29 29 29 29 29 29 29 29 29 29 29 29 29 29 29 29 32 29 32 32 32 29 32 32 29 29 0 0 0 0 0 0 0 0 0 0 0 0 0 29 
29 4 0 0 0 0 0 0 0 0 45 0 45 0 0 0 45 0 0 0 0 0 0 0 0 0 0 0 0 0 0 0 4 2 0 0 0 0 10 0 0 0 4 0 3 1 0 0 3 3 3 4 0 0 0 10 10 0 0 0 0 0 0 0 0 0 0 0 0 0 0 0 0 0 0 0 0 0 0 0 0 0 29 29 32 32 29 32 29 29 3 3 3 29 0 0 0 0 0 0 0 0 0 0 0 0 0 29 
29 4 4 0 0 0 0 0 0 0 45 0 45 0 0 0 45 0 0 0 0 0 0 0 0 0 0 0 0 0 0 0 29 29 0 0 0 0 11 0 0 0 4 3 3 0 0 0 0 3 1 4 0 0 0 10 10 0 0 0 0 0 0 0 0 0 0 0 0 0 0 0 0 0 0 0 0 29 0 0 0 0 29 3 3 3 3 3 3 3 3 3 3 29 0 0 0 0 0 0 0 0 0 0 0 0 3 29 
29 4 4 4 0 0 0 0 0 0 46 0 45 0 0 0 46 0 0 0 29 29 0 0 0 0 0 29 29 0 0 0 29 29 29 0 0 0 10 0 0 0 4 3 0 0 0 0 0 0 3 4 0 0 0 10 10 0 0 0 0 0 0 0 0 0 0 0 0 0 0 0 0 0 0 0 0 0 0 0 0 0 29 6 31 35 31 32 29 38 3 3 3 29 0 0 0 0 0 0 0 0 0 0 0 0 3 29 
29 2 4 2 4 0 0 0 0 0 0 0 45 0 0 0 0 0 0 0 29 29 29 29 0 0 0 0 0 0 0 0 4 2 4 0 0 29 11 0 0 0 4 1 3 0 0 0 0 1 3 4 0 0 0 10 10 0 0 0 0 0 0 0 0 0 0 0 0 0 0 0 0 0 0 0 29 0 0 0 0 0 29 31 39 35 31 31 28 28 28 29 29 28 0 0 0 0 0 0 0 0 0 0 0 5 5 29 
29 29 29 2 2 4 0 0 0 0 0 0 45 0 0 0 0 0 0 0 29 29 29 29 29 0 0 0 0 0 0 0 4 2 4 0 0 29 29 0 0 0 4 2 6 3 0 0 2 5 6 4 0 0 0 10 10 0 0 0 0 0 0 0 0 0 0 0 29 0 0 0 0 0 0 0 0 0 0 0 0 0 0 0 9 0 0 0 9 0 0 0 9 0 0 0 0 0 0 0 0 0 0 0 3 6 5 29 
29 2 2 2 2 4 4 0 0 0 0 0 0 0 0 0 44 0 0 0 29 29 29 29 29 29 0 0 0 0 0 0 4 2 4 0 0 29 29 29 29 0 4 1 3 6 3 3 3 6 3 4 0 0 0 10 10 0 0 0 0 0 0 0 0 0 0 0 0 0 0 0 0 29 0 0 0 0 0 0 0 0 0 0 10 0 0 0 10 0 0 0 10 0 0 0 0 0 0 0 0 0 0 0 5 3 5 29 
29 29 29 29 29 29 29 29 0 0 44 0 0 0 0 0 45 0 0 0 29 29 29 29 29 29 29 29 29 0 0 0 4 2 29 0 0 28 28 28 29 0 4 3 6 3 29 29 3 6 6 4 0 0 0 11 10 0 0 0 0 0 0 0 29 29 0 0 0 0 0 0 0 0 0 0 0 0 0 0 0 0 0 0 10 0 0 0 10 0 0 0 10 0 0 0 0 0 0 0 0 0 0 5 6 1 5 29 
29 29 29 29 29 29 29 29 0 0 46 0 44 0 0 0 45 0 0 0 29 29 29 29 29 29 29 28 28 29 33 32 28 32 29 0 0 29 29 29 29 0 4 3 29 31 31 31 31 29 3 4 0 0 29 29 29 0 0 0 29 0 0 0 0 0 0 0 0 0 0 0 0 0 0 0 0 0 0 0 0 0 0 0 10 0 0 0 10 0 0 0 10 0 0 0 0 0 0 0 0 0 5 3 3 1 5 29 
29 29 29 2 2 2 4 4 4 0 29 0 46 0 0 0 46 0 0 0 0 0 0 0 0 29 29 33 29 28 28 33 28 28 29 0 0 0 11 0 0 0 4 29 31 31 28 31 31 31 29 4 0 0 29 29 29 0 0 0 0 0 0 0 0 0 0 0 0 0 0 0 0 0 0 0 0 0 0 0 0 0 0 0 10 0 0 0 10 0 29 29 10 0 0 0 0 0 0 0 0 5 3 1 1 1 6 29 
29 2 2 2 2 2 2 4 4 4 0 0 29 0 0 0 29 29 29 29 29 29 29 29 0 0 0 2 2 0 0 0 4 2 4 0 0 0 10 0 0 0 29 31 28 28 28 28 31 32 31 29 0 0 0 10 10 0 0 0 0 0 29 0 0 0 0 0 0 0 0 0 0 0 0 0 0 0 0 0 0 0 0 0 10 0 0 0 10 29 29 29 10 0 0 0 0 0 0 0 5 6 6 5 5 1 3 29 
29 29 29 2 2 2 2 2 2 4 4 4 0 0 0 0 0 0 0 0 0 0 0 0 0 0 0 2 2 29 0 0 4 2 4 0 0 0 10 0 29 29 32 32 31 32 30 28 31 28 32 31 29 29 0 10 10 0 0 29 0 29 29 29 0 0 0 29 0 0 0 0 0 0 0 0 0 0 0 0 0 0 0 0 10 0 0 0 10 0 0 0 10 0 0 0 29 0 0 5 3 1 1 1 6 3 1 29 
29 2 2 2 2 2 2 2 2 2 29 4 4 0 0 0 29 0 0 0 0 0 0 29 0 0 0 2 29 34 29 0 4 2 4 29 0 0 11 29 31 32 32 32 31 32 31 31 32 28 32 31 31 31 29 11 11 0 0 29 0 29 29 29 0 0 29 29 29 0 0 0 0 0 0 0 0 0 0 29 29 0 0 0 10 0 29 29 10 0 0 0 10 0 0 0 29 0 5 5 5 5 5 5 5 5 5 29 
29 29 29 29 29 29 29 29 29 29 29 31 29 29 29 29 29 29 29 29 29 29 29 29 29 29 29 29 29 30 30 29 29 29 32 32 29 29 30 30 30 32 29 30 29 29 31 31 31 31 28 31 31 32 32 29 29 29 29 29 0 32 29 29 29 29 29 29 29 29 29 29 29 29 29 33 33 29 29 29 29 29 29 29 29 29 29 29 33 0 29 0 29 0 29 0 29 29 29 29 29 29 29 29 29 29 29 29 
29 29 32 29 32 29 32 32 32 29 31 31 29 29 31 29 31 28 31 28 29 29 28 29 28 29 28 28 28 30 30 29 30 29 30 30 30 29 29 29 32 32 30 30 30 30 32 32 32 32 32 29 29 32 32 29 29 29 29 29 0 32 29 32 32 32 32 29 29 32 29 29 31 31 37 33 37 37 31 29 29 29 31 31 33 31 31 31 29 0 29 0 29 0 29 0 29 29 29 29 29 29 29 29 29 29 29 29 
29 32 32 29 29 32 32 32 29 31 31 29 31 31 31 31 31 31 31 29 29 29 29 29 28 28 28 30 29 30 30 30 30 29 29 29 30 30 30 29 29 29 29 32 32 32 29 32 32 32 29 32 29 29 29 29 29 29 29 29 0 29 29 29 29 33 29 29 29 29 29 33 29 29 31 31 33 33 31 31 33 33 33 33 37 37 29 29 29 0 29 0 29 0 29 0 29 29 29 29 29 29 29 29 29 29 29 29 
