88
33
28 28 28 28 28 28 28 28 28 28 28 28 28 28 28 28 28 28 28 28 28 28 28 28 28 28 28 28 28 28 28 28 28 28 28 28 28 28 28 28 28 28 28 28 28 28 28 28 28 28 28 28 28 28 28 28 28 28 28 28 28 28 28 28 28 28 28 28 28 28 28 28 28 28 28 28 28 28 28 28 28 28 28 28 28 28 28 27 
27 0 0 0 0 0 0 0 0 0 0 0 0 0 0 0 0 0 0 0 0 0 0 0 0 0 0 0 0 0 0 0 0 0 0 0 0 0 0 0 0 0 0 0 0 0 0 0 0 0 0 0 0 0 0 0 0 0 0 0 0 0 0 0 0 0 0 0 0 0 0 0 0 0 0 0 0 0 0 0 0 0 0 0 0 0 0 27 
27 12 13 0 0 0 0 0 0 0 0 0 0 0 0 0 0 0 0 0 0 0 0 0 0 0 0 0 0 0 0 0 0 0 0 0 0 0 0 0 0 0 0 0 0 0 0 0 0 0 0 0 0 0 0 0 0 0 0 0 0 0 0 0 0 0 0 0 0 0 0 0 0 0 0 0 0 0 0 0 0 0 0 0 0 12 13 27 
27 14 15 0 0 0 0 0 0 0 0 0 0 0 0 0 0 0 0 0 0 0 0 0 0 0 0 0 0 0 0 0 0 0 0 0 0 0 0 0 0 0 0 0 0 0 0 0 0 0 0 0 0 0 0 0 0 0 0 0 0 0 0 0 0 0 0 0 0 0 0 0 0 0 0 0 0 0 0 0 0 0 0 0 0 14 15 27 
27 27 27 27 27 27 27 27 27 27 0 0 0 0 27 0 0 0 0 0 0 0 0 0 0 0 0 0 0 0 0 0 0 0 0 0 0 0 0 0 0 0 0 0 0 0 0 0 0 0 0 0 0 0 0 0 0 0 0 0 0 0 0 0 0 0 0 0 0 0 0 0 0 0 0 0 0 0 0 0 0 0 0 0 0 27 27 27 
27 0 0 0 0 0 0 0 0 0 0 0 0 0 27 0 0 0 0 0 0 0 0 0 0 0 0 0 0 0 0 0 0 0 0 0 0 0 0 0 0 0 0 0 0 0 0 0 0 0 0 0 0 0 0 0 0 0 0 0 0 0 0 0 0 0 0 0 0 0 0 0 0 0 0 0 0 0 0 0 0 0 0 0 27 0 0 27 
27 0 0 0 0 0 0 0 0 0 0 0 0 0 27 0 0 0 0 0 0 0 0 0 0 0 0 0 35 0 0 0 0 0 0 0 0 0 0 0 0 0 0 0 0 0 0 0 0 0 0 0 0 0 0 0 0 0 0 0 0 0 0 0 0 0 0 0 0 0 0 0 0 0 0 0 4 0 0 0 0 4 0 0 0 0 0 27 
27 0 0 0 0 0 0 0 0 0 0 0 0 0 27 0 0 0 0 0 0 0 0 0 0 35 0 0 0 0 0 26 25 0 0 0 26 25 0 0 26 23 23 25 0 0 0 0 0 0 0 0 0 0 0 0 0 0 0 0 0 0 0 0 0 0 0 0 0 0 0 27 27 27 0 0 27 27 27 27 27 27 0 0 0 0 0 27 
27 0 0 0 0 0 0 0 0 0 0 0 0 0 27 0 0 0 0 0 0 0 0 0 0 0 0 0 0 0 0 25 0 0 0 0 25 0 0 0 0 0 0 0 0 0 0 0 0 0 0 0 0 0 0 0 0 0 0 0 0 0 0 0 0 0 0 0 0 0 27 27 27 27 0 0 27 27 27 27 27 27 0 0 0 0 0 27 
27 0 0 0 0 0 0 0 0 0 0 0 0 0 27 0 0 0 0 0 0 0 0 35 0 0 0 0 0 0 0 0 0 0 0 0 0 0 0 0 0 0 0 0 0 0 0 0 0 0 0 0 0 0 0 0 0 0 0 0 0 0 0 0 0 0 0 0 0 27 27 27 27 27 0 0 27 27 27 27 27 27 0 0 0 0 0 27 
27 0 0 0 0 0 0 0 0 0 0 0 0 0 27 0 0 0 0 0 0 0 0 0 0 0 0 26 25 0 0 0 0 0 0 0 0 0 0 0 0 0 0 0 0 0 0 0 0 0 0 0 0 0 0 0 0 0 0 0 0 0 0 0 0 0 0 0 27 27 27 27 27 27 0 0 27 27 27 27 27 27 0 0 0 0 0 27 
27 0 0 0 0 0 0 0 0 0 0 0 0 0 27 0 0 0 0 0 0 0 0 0 0 0 0 0 0 0 0 0 0 0 0 0 0 0 0 0 0 0 0 0 0 0 27 0 0 0 0 0 0 0 0 0 0 0 0 0 0 0 0 0 0 0 0 27 27 27 27 27 27 27 0 0 27 27 27 27 27 27 0 0 0 0 0 27 
27 0 0 0 0 0 0 0 0 27 27 27 27 27 27 0 0 0 0 0 0 0 0 0 0 0 0 0 0 0 26 25 0 0 0 0 0 0 27 0 0 0 0 0 0 27 27 0 0 0 0 0 0 0 0 0 0 0 0 0 0 0 0 0 0 0 27 27 27 27 27 27 27 27 0 0 27 27 27 27 27 27 0 0 0 0 0 27 
27 0 0 0 0 0 0 0 0 0 0 0 0 0 0 0 0 0 0 0 0 0 0 0 0 0 0 0 0 0 0 0 0 0 4 0 0 0 27 0 0 0 1 0 27 27 27 0 0 0 0 0 0 0 0 0 0 0 0 0 0 0 0 0 0 27 27 27 27 27 27 27 27 27 0 0 27 27 27 27 27 27 0 0 0 0 0 27 
27 0 0 0 0 27 27 0 0 0 0 0 0 0 0 0 0 0 0 0 0 0 0 0 0 0 0 0 0 0 0 0 35 0 27 27 27 27 27 27 27 27 27 27 27 27 27 27 27 27 27 27 0 0 0 35 0 0 27 0 0 0 0 0 0 27 27 27 27 27 27 27 27 27 0 0 27 27 27 27 27 27 0 0 0 0 0 27 
27 0 0 0 0 0 0 0 0 0 0 0 0 0 0 0 0 0 0 0 0 0 0 0 0 0 0 0 0 0 0 35 0 0 0 0 0 0 0 0 27 27 27 27 27 27 27 27 27 27 27 27 35 0 0 0 0 0 27 0 0 0 0 35 0 27 27 27 27 27 27 27 27 27 0 0 27 27 27 27 27 27 0 0 0 0 0 27 
27 0 27 0 0 0 0 0 0 0 0 0 0 0 0 0 0 0 0 0 0 0 0 0 0 0 0 0 0 0 35 0 0 0 0 0 0 0 0 0 27 27 27 27 27 27 27 27 27 27 27 27 0 0 35 0 0 0 27 0 35 0 0 0 0 27 27 27 27 27 27 27 27 27 0 0 27 27 27 27 27 27 0 0 0 0 0 27 
27 0 0 0 0 0 0 0 0 0 0 0 0 0 0 0 0 0 0 0 0 0 0 0 0 0 0 0 0 35 0 0 0 0 0 0 0 0 0 0 27 27 27 27 27 27 27 27 27 27 27 27 0 0 0 0 25 0 27 0 0 0 0 0 0 27 27 27 27 27 27 27 27 27 0 0 27 27 27 27 27 27 0 0 0 0 0 27 
27 0 0 0 27 0 0 0 0 0 0 0 0 0 0 0 0 0 0 0 0 0 0 0 0 0 0 0 35 0 0 0 0 0 0 0 0 0 0 0 27 27 27 27 27 27 27 27 27 27 27 27 0 0 0 24 0 0 27 0 0 0 0 0 0 27 27 27 27 27 27 27 27 27 0 0 27 27 27 27 27 27 0 0 0 0 0 27 
27 0 0 0 0 0 0 0 0 0 0 0 0 0 0 0 0 0 0 0 0 0 0 0 0 0 0 0 0 0 0 0 0 0 0 0 0 0 0 0 27 27 27 27 27 27 27 27 27 27 27 27 0 0 26 0 0 0 27 0 0 0 0 0 0 27 27 27 27 27 27 27 27 27 0 0 27 27 27 27 27 27 0 0 0 0 0 27 
27 0 0 0 0 0 0 27 0 0 27 27 27 4 26 0 0 0 0 0 25 27 27 0 0 27 27 0 0 0 0 0 0 0 0 27 27 0 0 0 27 27 27 27 27 27 27 27 27 27 27 27 26 0 0 0 0 0 27 0 0 0 0 0 0 27 27 27 27 27 27 27 27 27 0 0 27 27 27 27 27 27 0 0 0 0 0 4 
27 0 0 0 0 0 0 27 0 0 27 27 27 4 0 26 0 0 0 25 0 27 27 0 0 27 27 26 0 0 0 0 0 0 25 27 27 0 0 0 27 27 27 27 27 27 27 27 27 27 27 27 0 26 0 0 0 0 27 0 0 0 0 0 0 27 27 27 27 27 27 27 27 27 0 0 27 27 27 27 27 27 0 0 0 0 0 4 
27 0 0 0 0 27 0 27 0 0 27 27 27 4 0 0 0 0 0 0 0 27 27 0 0 27 27 0 26 0 0 0 0 25 0 27 27 0 0 0 27 27 27 27 27 27 27 27 27 27 27 27 0 0 26 0 0 0 0 0 0 0 0 0 0 0 0 0 0 0 0 0 0 0 0 0 0 0 0 27 27 27 0 0 0 0 0 4 
27 0 0 27 0 0 0 27 0 0 27 27 27 4 0 0 0 0 0 0 0 27 27 0 0 27 27 0 0 26 0 0 25 0 0 27 27 0 0 0 27 27 27 27 27 27 27 27 27 27 27 27 0 0 0 26 0 0 0 0 0 0 0 0 0 0 0 0 0 0 0 0 0 0 0 0 0 0 0 27 27 27 0 0 0 0 0 4 
27 0 0 0 0 0 0 27 0 0 27 27 27 4 0 0 0 0 0 0 0 27 27 0 0 27 27 0 0 0 0 0 0 0 0 27 27 0 0 0 27 27 27 27 27 27 27 27 27 27 27 27 0 0 0 0 0 0 0 0 0 0 0 0 0 0 0 0 0 0 0 0 0 0 0 0 0 0 0 27 27 27 0 0 0 0 0 4 
27 0 0 0 0 0 0 27 0 0 27 27 27 4 0 0 0 0 0 0 0 27 27 0 0 27 27 0 0 0 0 0 0 0 0 27 27 0 0 0 0 0 27 0 0 0 0 0 27 0 0 0 0 0 0 0 27 27 0 0 0 0 0 0 0 0 0 0 0 0 0 0 0 0 0 0 0 0 0 27 27 27 0 0 0 0 0 4 
27 0 0 0 0 0 0 27 0 0 27 27 27 4 0 0 0 0 0 0 0 27 27 0 0 27 27 0 0 0 0 0 0 0 0 27 27 0 0 0 0 0 0 0 0 0 0 0 0 0 0 0 0 0 0 27 27 27 0 0 27 0 0 0 27 27 27 27 27 27 27 0 0 0 0 0 0 0 0 0 0 0 0 0 0 12 13 4 
27 0 0 0 0 0 0 27 0 0 27 27 27 4 0 0 0 0 0 0 0 27 27 0 0 27 27 0 0 0 0 0 0 0 0 27 27 0 0 0 0 0 0 0 0 27 0 0 0 0 0 27 0 0 0 4 27 27 0 0 27 0 0 0 27 27 27 27 27 27 27 4 4 4 0 0 4 4 4 4 4 4 0 0 0 14 15 4 
27 0 0 0 0 0 0 27 0 0 27 4 4 4 0 0 0 0 0 0 0 4 27 0 0 4 27 0 0 0 0 0 0 0 0 26 24 23 23 23 23 24 23 24 25 4 26 24 24 24 25 4 26 25 27 27 4 4 0 0 4 0 0 0 4 4 27 27 27 4 4 4 4 4 0 0 4 4 4 4 27 27 27 4 27 27 27 27 
4 0 0 0 0 0 0 4 0 0 4 4 4 4 0 0 0 0 0 0 0 4 4 0 0 4 4 0 0 0 0 0 0 0 0 0 0 0 0 0 0 0 0 0 0 4 0 0 0 0 0 4 0 0 4 4 4 4 0 0 4 0 0 0 4 4 4 4 4 4 4 4 4 4 0 0 4 4 4 4 4 4 4 4 4 4 4 4 
4 0 0 0 0 0 0 4 0 0 4 4 4 4 0 0 0 0 0 0 0 4 4 0 0 4 4 0 0 0 0 0 0 0 0 0 0 0 0 0 0 0 0 0 0 4 0 0 0 0 0 4 0 0 4 4 4 4 0 0 4 0 0 0 4 4 4 4 4 4 4 4 4 4 0 0 4 4 4 4 4 4 4 4 4 4 4 4 
4 0 0 0 0 0 0 4 0 0 4 4 4 4 0 0 0 0 0 0 0 4 4 0 0 4 4 0 0 0 0 0 0 0 0 0 0 0 0 0 0 0 0 0 0 4 0 0 0 0 0 4 0 0 4 4 4 4 0 0 4 0 0 0 4 4 4 4 4 4 4 4 4 4 0 0 4 4 4 4 4 4 4 4 4 4 4 4 
4 0 0 0 0 0 0 4 0 0 4 4 4 4 0 0 0 0 0 0 0 4 4 0 0 4 4 0 0 0 0 0 0 0 0 0 0 0 0 0 0 0 0 0 0 4 0 0 0 0 0 4 0 0 4 4 4 4 0 0 4 0 0 0 4 4 4 4 4 4 4 4 4 4 0 0 4 4 4 4 4 4 4 4 4 4 4 4 
