81
9
24 4 0 0 0 0 0 0 0 0 0 0 0 0 0 0 0 0 0 0 0 0 0 0 0 0 0 0 0 0 0 0 0 0 0 0 0 0 0 0 0 0 0 0 0 22 22 22 22 22 22 22 22 22 3 24 24 24 24 24 24 24 24 24 24 24 24 24 24 24 24 24 24 24 24 24 24 24 24 24 0 
24 4 0 0 0 0 0 0 0 0 0 0 0 0 0 0 0 0 0 0 0 0 0 0 0 0 0 0 0 0 0 0 0 0 0 0 0 0 0 0 0 0 0 0 0 0 0 0 0 22 22 22 22 22 3 24 24 24 24 24 24 24 24 24 24 24 24 24 24 24 24 24 24 24 24 24 24 24 24 24 0 
24 4 0 0 0 0 0 0 0 0 0 0 0 0 0 0 0 0 0 0 0 0 0 0 0 0 0 0 0 0 0 0 0 0 0 0 0 0 0 0 0 0 0 0 0 0 0 0 0 22 22 22 22 22 3 24 24 24 19 17 17 17 17 17 17 17 17 17 17 17 17 17 17 17 17 18 24 24 24 24 0 
24 4 0 0 0 0 0 0 0 0 0 0 0 0 20 21 0 0 0 0 0 0 0 0 0 0 1 23 23 23 2 0 0 0 0 0 0 0 0 0 0 0 0 0 0 0 20 21 0 0 0 0 22 22 0 17 17 17 22 0 0 0 0 0 0 0 0 0 0 0 0 0 0 0 0 3 24 24 24 24 0 
24 4 0 0 0 0 0 0 0 0 0 0 11 1 23 23 2 0 0 0 1 23 23 23 23 23 23 24 24 24 4 0 0 0 0 0 0 0 0 0 0 0 0 0 0 1 23 23 23 2 0 0 0 0 1 23 23 2 0 0 0 0 0 0 0 0 20 21 0 0 0 0 0 0 0 3 24 24 24 24 0 
24 4 0 0 0 0 0 0 0 0 1 23 23 23 6 5 23 2 0 0 3 24 24 24 24 24 24 24 24 24 4 25 26 27 0 0 0 0 0 0 0 25 26 27 0 3 24 24 5 23 23 23 23 23 23 6 24 4 0 0 0 0 0 0 1 23 23 23 2 0 0 0 0 0 0 3 24 24 24 24 0 
24 4 9 0 10 20 21 0 0 11 1 24 24 24 24 24 5 23 2 0 3 24 24 24 24 24 24 24 24 24 4 0 0 0 0 0 25 26 27 0 0 0 0 0 0 3 24 24 24 24 24 24 24 24 24 24 5 23 23 23 23 23 23 23 23 6 24 5 23 23 23 23 23 23 23 23 6 24 24 24 0 
24 23 23 23 23 23 23 23 23 23 23 6 24 24 24 24 24 5 23 2 3 24 24 24 24 24 24 24 24 24 16 16 16 16 16 16 16 16 16 16 16 16 16 16 16 16 24 24 24 24 24 24 24 24 24 24 24 24 24 24 24 24 24 24 24 24 24 24 24 24 24 24 24 24 24 24 24 24 24 24 0 
24 24 24 24 24 24 24 24 24 24 24 24 24 24 24 24 24 24 24 24 24 24 24 24 24 24 24 24 24 24 24 24 24 24 24 24 24 24 24 24 24 24 24 24 24 24 24 24 24 24 24 24 24 24 24 24 24 24 24 24 24 24 24 24 24 24 24 24 24 24 24 24 24 24 24 24 24 24 24 24 0 
