97
21
34 34 34 34 34 34 34 34 34 34 34 34 34 34 34 34 34 34 34 30 0 0 27 4 4 4 4 4 4 4 4 4 4 4 4 4 4 4 0 27 0 0 0 0 0 0 0 0 0 0 0 0 0 0 0 0 0 0 0 0 0 0 0 0 0 0 0 0 0 0 0 0 0 0 0 0 0 0 0 0 0 0 0 0 0 0 0 0 27 4 4 4 27 27 27 27 27 
34 34 34 34 34 34 34 34 34 34 34 34 34 34 34 34 34 34 34 30 0 0 27 4 4 7 4 4 4 4 4 4 4 4 4 4 4 4 4 27 0 0 0 0 0 0 0 0 0 0 0 0 0 0 0 0 0 0 0 0 0 0 0 0 0 0 0 0 0 0 0 0 0 0 0 0 0 0 0 0 0 0 0 0 0 0 0 0 27 4 4 4 27 27 27 27 27 
34 34 34 34 34 34 34 34 34 34 34 34 34 34 34 34 34 34 34 30 0 0 27 4 4 7 7 4 4 4 4 4 4 4 4 4 4 4 4 4 0 0 0 0 0 0 0 0 0 0 0 0 0 0 0 0 0 0 0 0 0 0 0 0 0 0 0 0 0 0 0 0 0 0 0 0 0 0 0 0 0 0 0 0 0 0 0 0 27 4 4 4 27 27 27 27 27 
34 34 34 34 34 34 34 34 34 34 34 34 34 34 34 34 34 34 34 30 0 0 27 7 6 6 4 4 4 4 4 4 4 4 4 4 4 4 4 27 0 0 0 0 0 0 0 0 0 0 0 0 0 0 0 0 0 0 0 0 0 0 0 0 0 0 0 0 0 0 0 0 0 0 0 0 0 0 0 0 0 0 0 0 0 0 0 0 27 4 4 4 27 27 27 27 27 
34 34 34 34 34 34 34 34 34 34 34 34 34 34 34 34 34 34 34 30 0 0 27 4 6 5 4 4 4 4 4 4 4 4 4 4 4 4 4 27 0 0 0 0 0 0 0 0 0 0 0 0 0 0 0 0 0 0 0 0 0 0 0 0 0 0 0 0 0 0 0 0 0 0 0 0 0 0 0 0 0 0 0 0 0 0 0 0 27 4 4 4 27 27 27 27 27 
34 34 34 34 34 34 34 34 34 34 34 34 34 34 34 34 34 34 34 34 0 0 27 4 4 4 4 4 4 4 5 7 7 4 4 4 4 4 4 27 0 0 0 0 0 0 0 0 0 0 0 0 0 0 0 0 0 0 0 0 0 0 0 0 0 0 0 0 0 0 0 0 0 0 0 0 0 0 0 0 0 0 0 0 0 0 0 0 27 4 4 4 27 27 27 27 27 
30 0 0 0 0 0 0 0 0 0 0 0 0 0 0 0 0 0 0 0 0 0 27 4 5 5 5 4 4 4 5 6 7 7 6 5 4 4 4 27 0 0 0 0 0 0 0 0 0 0 0 0 0 0 0 0 0 35 0 0 0 0 0 0 0 0 0 0 0 0 0 0 0 0 0 0 0 0 3 0 0 0 0 0 0 0 0 0 27 4 4 4 27 27 27 27 27 
30 0 0 0 0 0 0 0 0 0 0 0 0 0 0 0 0 0 20 21 0 0 27 4 5 6 6 7 4 4 4 4 4 4 4 5 4 4 4 27 0 0 0 0 0 0 3 0 0 0 0 35 0 0 0 0 0 0 0 0 0 0 0 0 0 0 0 0 0 0 0 0 0 0 0 0 27 27 27 27 27 27 27 27 0 0 0 0 27 4 4 4 27 27 27 27 27 
30 30 30 30 30 30 30 30 30 30 29 29 29 29 28 28 28 28 27 27 0 0 27 4 4 6 6 7 7 6 4 4 4 4 4 4 4 4 4 27 0 0 0 0 0 26 24 25 0 0 0 0 0 0 0 0 0 0 0 0 0 0 0 0 0 0 0 0 0 0 0 0 0 0 0 0 27 4 4 4 4 4 4 27 0 0 0 0 27 4 4 4 27 27 27 27 27 
30 30 30 30 30 30 30 30 30 30 29 29 29 28 28 28 28 27 27 27 0 0 27 4 4 7 7 7 7 6 4 4 4 4 7 7 4 4 4 27 0 0 0 0 0 0 0 0 0 0 0 0 0 0 0 0 0 0 0 0 0 3 0 0 0 0 0 0 0 0 0 0 0 0 0 26 27 27 27 27 27 4 4 27 0 0 0 0 27 4 4 4 27 27 27 27 27 
30 30 30 30 30 30 30 30 30 29 29 29 29 28 28 28 27 27 27 27 0 0 27 4 4 4 4 4 4 4 4 4 4 7 7 7 4 4 4 27 0 26 25 0 0 0 0 0 12 13 0 0 0 0 0 0 0 0 0 0 0 35 0 0 0 0 0 0 0 0 0 0 0 0 0 0 0 16 17 0 27 4 4 27 0 0 0 0 27 4 4 4 27 27 27 27 27 
30 30 30 30 30 30 30 30 30 29 29 29 28 28 28 28 27 27 27 27 0 0 27 4 4 4 4 4 4 4 4 4 4 7 4 4 4 4 4 27 0 0 0 0 0 0 0 3 14 15 3 0 0 0 0 0 0 0 0 0 0 0 0 0 0 0 0 0 0 0 0 0 0 35 0 0 0 18 19 0 27 4 4 27 0 0 0 0 27 4 4 27 27 27 27 27 27 
30 30 30 30 30 30 30 30 30 29 29 29 28 28 28 28 27 27 27 27 0 0 27 4 4 4 4 4 4 4 4 4 4 4 4 4 4 4 4 27 0 0 0 0 0 27 27 27 27 27 27 0 0 0 0 0 0 0 0 0 0 0 0 0 0 0 0 0 0 0 0 0 0 0 0 0 0 0 0 0 27 4 4 27 0 0 0 0 27 4 4 27 27 27 27 27 27 
30 30 30 30 30 30 30 30 29 29 29 28 28 28 28 27 27 27 27 27 0 0 31 31 31 31 31 31 31 31 31 31 31 31 31 31 31 31 31 31 0 0 0 0 0 27 4 4 4 4 27 0 0 0 0 0 0 0 0 0 0 0 0 0 0 0 0 0 0 0 35 0 0 0 0 0 0 0 0 0 27 4 4 27 0 0 0 0 27 4 4 27 27 27 27 27 27 
4 4 4 4 4 4 30 30 29 29 28 28 28 28 28 27 27 27 27 27 0 0 0 16 17 0 7 7 7 7 0 16 17 7 7 7 7 16 17 0 0 0 22 0 27 27 4 4 4 4 27 0 0 0 0 0 0 0 0 0 0 0 0 0 0 0 0 0 0 0 0 0 0 0 0 0 0 0 0 0 27 4 4 27 0 0 0 0 27 4 4 27 27 27 27 27 27 
4 4 4 4 4 4 30 29 29 29 28 28 28 28 27 27 27 27 27 27 0 0 0 18 19 0 7 7 7 7 0 18 19 7 7 7 7 18 19 0 0 0 27 27 27 4 4 4 4 4 27 0 0 0 0 0 0 0 0 0 0 0 0 0 0 0 0 0 0 0 0 0 0 0 0 0 0 0 0 0 27 27 27 27 0 0 0 0 27 4 4 27 27 27 27 27 27 
4 4 4 4 4 4 29 29 29 29 28 28 28 28 27 27 27 27 27 27 0 0 0 0 0 27 7 7 7 7 27 0 0 7 27 27 7 0 0 27 27 27 27 4 4 4 4 4 4 4 27 0 0 0 0 0 0 0 0 0 0 0 0 0 0 0 0 0 0 0 0 0 0 0 0 0 0 0 0 0 27 0 0 0 0 0 0 0 0 0 0 0 27 27 27 27 27 
4 4 4 4 4 4 4 4 4 4 4 4 4 4 4 4 4 4 4 27 0 0 1 0 0 27 27 27 27 27 27 0 0 7 27 27 7 0 0 27 4 4 4 4 4 4 4 4 4 4 27 0 0 0 0 0 0 0 0 0 0 0 0 0 0 0 0 0 0 0 0 0 0 0 0 0 0 0 0 0 27 0 0 0 0 0 2 0 0 0 0 0 27 27 27 27 27 
4 4 4 4 4 4 4 4 4 4 4 4 4 4 4 4 4 4 4 27 27 27 27 27 27 27 27 27 27 27 27 27 27 27 27 27 27 27 27 27 27 27 27 27 27 27 27 27 27 4 27 0 0 0 0 0 0 0 0 0 0 0 0 0 0 0 0 0 0 0 0 0 0 0 0 0 0 0 0 0 27 4 4 4 27 27 27 27 27 4 4 4 27 27 27 27 27 
4 4 4 4 4 4 4 4 4 4 4 4 4 4 4 4 4 4 4 4 4 4 4 4 4 4 4 4 4 4 4 4 4 4 4 4 4 4 4 4 4 4 4 4 4 4 4 4 4 4 27 0 0 0 0 0 0 0 0 0 0 0 0 0 0 0 0 0 0 0 0 0 0 0 0 0 0 0 0 0 0 0 0 0 0 0 0 0 0 0 0 0 0 0 0 0 0 
4 4 4 4 4 4 4 4 4 4 4 4 4 4 4 4 4 4 4 4 4 4 4 4 4 4 4 4 4 4 4 4 4 4 4 4 4 4 4 4 4 4 4 4 4 4 4 4 4 4 27 0 0 0 0 0 0 0 0 0 0 0 0 0 0 0 0 0 0 0 0 0 0 0 0 0 0 0 0 0 0 0 0 0 0 0 0 0 0 0 0 0 0 0 0 0 0 
